PayPal	PayPal
Visa	Visa
MasterCard	MasterCard
Ethereum	ETH
BNB	BNB
Cardano	ADA
Avalanche	AVAX
Ethereum Classic	ETC
Stellar	XLM
Algorand	ALGO
VeChain	VET
Tezos	XTZ
EOS	EOS
Neo	NEO
Fantom	FTM
Stacks	STX
Zilliqa	ZIL
Waves	WAVES
NEM	XEM
Celo	CELO
Qtum	QTUM
Kadena	KDA
Moonbeam	GLMR
ICON	ICX
Flux	FLUX
Serum	SRM
Lisk	LSK
Cryptonex	CNX
Conflux	CFX
Stratis	STRAX
Shentu	CTK
Moonriver	MOVR
Dero	DERO
Telos	TLOS
KardiaChain	KAI
Ã†ternity	AE
Kin	KIN
Cortex	CTXC
Hathor	HTR
Shiden Network	SDN
GoChain	GO
Edgeware	EDG
v.systems	VSYS
Enecuum	ENQ
Plian	PI
Lamden	TAU
RChain	REV
Achain	ACT
Metaverse ETP	ETP
Metrix Coin	MRX
TrueChain	TRUE
Vexanium	VEX
Idena	IDNA
Gather	GTH
High Performance Blockchain	HPB
ODIN PROTOCOL	ODIN
Origo	OGO
Noah Coin	NOAHP
MOAC	MOAC
SonoCoin	SONO
Amoveo	VEO
Kulupu	KLP
Internet Computer	ICP
Harmony	ONE
Nervos Network	CKB
Constellation	DAG
AIOZ Network	AIOZ
Bytom	BTM